7,36
####################################
#E#  ##  ######## # #     #      # #
# #   #             # #        #   #
#   # ##### ## ###### # #######  # #
### # ##    ##      # # #     #### #
#   #    #  #######   #   ###    #S#
####################################
